1111111111111111111111111111111111
100000000000000C00000C000000000001
1010000100100000000001000000000101
1000000000001010000001000000010101
100000000C00C0000000000000000000C1
1010000100100000000001000000000101
1E00000000001010000001000000010101
1P0000000000000C00000C000000000001
1111111111111111111111111111111111