111111111111111111111111111
101000000000000C00000C00001
11001000000E000100000000001
100000000000000C00000C00001
101001010010000010100100001
101001001010101000100100001
100000010C00C00000000000001
111111111111111111111111111